11111111111111111111111111
1P1001C00000000010000000E1
10100010001110000000000011
1010110000000000000C000011
1000110000C001100000110001
11000000000001100111000011
11001100N00000C00111000001
11111100001110000111000001
11011000CC0000011110000011
10011000000000000000000001
10011000000000011110000001
100000011000000C1011000001
11111111111111111111111111
